4 4 4 4 4 4 4 4 2 2 2 2 4 4 4 4 4 2 4 4 4 4 4 4 4
4 4 4 4 4 4 4 5 2 2 2 2 5 7 7 7 5 2 3 3 3 3 4 4 4 
4 7 5 4 4 4 4 5 2 2 2 2 5 7 7 7 5 6 3 3 2 2 4 4 4
4 5 5 5 5 5 5 5 5 5 5 5 5 5 5 5 5 2 3 3 2 2 4 4 4
4 4 4 4 4 4 4 4 4 4 4 4 4 5 6 7 5 6 3 3 5 5 5 4 4
4 4 4 4 4 4 4 4 4 4 6 7 7 5 6 7 5 2 3 3 5 7 7 7 4
4 3 3 3 3 5 5 5 5 5 6 7 7 5 6 7 5 6 3 3 5 7 7 7 4
6 6 6 6 6 5 2 2 2 5 4 4 4 5 6 7 5 2 4 2 5 7 7 7 4
4 6 6 6 3 5 2 2 2 5 5 5 5 5 5 5 5 5 5 5 5 5 5 5 4 
4 3 6 3 3 5 2 2 2 5 4 4 4 5 4 4 5 2 4 4 4 4 4 4 4
4 5 5 5 5 5 5 5 5 5 4 4 4 5 3 3 5 3 3 7 7 4 7 7 4 
4 6 6 6 6 4 4 5 3 4 4 4 4 5 3 3 5 2 4 7 7 4 7 7 4
4 2 2 2 2 2 4 5 5 5 5 5 5 5 3 3 5 3 3 3 3 3 3 3 4
4 7 5 5 5 5 5 5 3 2 2 2 3 5 3 3 5 2 4 7 7 4 7 7 4
4 7 5 7 7 7 4 5 3 2 2 2 3 5 7 7 5 3 4 4 4 4 4 4 4
4 7 5 7 7 7 4 5 3 2 2 2 3 5 7 7 5 2 3 2 3 2 3 2 2
4 7 5 7 7 7 4 5 3 2 2 2 3 5 5 5 5 5 5 5 5 5 5 5 4
4 4 5 4 4 4 4 5 4 4 4 4 4 5 4 4 4 4 4 4 4 4 4 4 4
4 4 5 4 4 4 4 5 4 4 4 4 4 5 4 4 4 4 4 4 4 4 4 4 4
4 4 4 4 4 4 4 4 4 4 4 4 4 4 4 4 4 4 4 4 4 4 4 4 4
